********************
*^>^>^>^*^* *v<v>v<*
*>v>v>*>^>*>*<v<v<v*
*v>v>v>v>v*^*v<v<v<*
*>v>v>v>v>*<**v<v<v*
*v>v>v>v>v*v*v<v<v<*
*>v>v>v>v*v<v<v<v<v*
*v>v^v>v><vv<v<v<v<*
*>v>v*v>^*v<v<v<v<v*
*v>v>v>^><vv<v<v<v<*
*>v>v>^>v*v<v<v<v<v*
*v>v>^>v<> <<<<<<<<*
*>^*^>v*^>^<^<^<^<^*
*^>^>v<^>v^^<^<*<^<*
*>^>v<^>v<^<^<^<^<^*
*^>v<^>v<^^^<^<^<^<*
**v<^>v<^>^<^<^<^<^*
*^<^>v<^>^^^<^<^<^<*
***>v<^>^>^<^<*<^<^*
*v>v<^>^*^^^<^<^<^<*
*>v<^>^>^>^<^<^<^<^*
*v<^>^>^>^^^<^<^<^<*
*<^>^>^>^>^<^<^<^<'*
********************
\\
playerx=18
playery=22
pushbuttonx=11
pushbuttony=1
magicwarpx=1
magicwarpy=1
logx=11
logy=6
pushbuttonx=6
pushbuttony=11
rollingstonex=17
rollingstoney=16
rollingstonex=6
rollingstoney=17
pushbuttonx=1
pushbuttony=17
rollingstonex=11
rollingstoney=19
logx=25
logy=21
pushbuttonx=10
pushbuttony=22
rollingstonex=17
rollingstoney=22
